NO ./images/wood.xpm
SO ./images/greystone.xpm
WE ./images/eagle.xpm
EA  ./images/mossy.xpm

F 220,100,0
C 225,30,0
1111111111111111111111111
100000000011000000000000111111111
101100000111000000000000000000001
1001000000000000E0000000111111111
111111111011000001110000000000001
100000000011000001110111111111111
111111111111111111111111111111111111



