NO ./images/wall2.xpm
SO ./images/wall32.xpm
WE ./images/wall1.xpm
EA ./images/wall8.xpm

C      200 ,     230,           255
F 80,60,30

        1111111111111111111111111
        1000000000100000000000001
        1011000000100000010000001
        1011000000100000010000001
        1011000000100000010000001
        1011000000100000010000001
        1011000000100000010000001
        1011000000100000010000001
        1001000000000011110000001
111111111011000001110000000000001
100000000011000001110011111111111
100000000011000001110011111111111
100000000011000001110011111111111
100000000011000001110011111111111
100000000011000001110011111111111
100000000011000001110011111111111
100000000011000001110011111111111
100000000011000001110011111111111
100000000011000001110011111111111
100000000011000001110E11111111111
100000000011000001110011111111111
100000000011000001110011111111111
100000000011000001110011111111111
100000000011000001110011111111111
100000000011000001110011111111111
100000000011000001110011111111111
100000000011000001110011111111111
100000000011000001110011111111111
100000000011000001110011111111111
1111111111111111111111111111111111111111