ç

C      200 ,     230,           255
F 80,60,30

        1111111111111111111111111
        10000000001000000000000S1
        1011000000100000010000001
        1011000000100000010000001
        1011000000100000010000001
        1011000000100000010000001
        1011000000100000010000001
        1011000000100000010000001
        1001000000000011110000001
111111111011000001110000000000001
100000000011000001110011111111111
100000000011000001110011111111111
100000000011000001110011111111111
100000000011000001110011111111111
100000000011000001110011111111111
100000000011000001110011111111111
100000000011000001110011111111111
100000000011000001110011111111111
100000000011000001110011111111111
100000000011000001110011111111111
100000000011000001110011111111111
100000000011000001110011111111111
100000000011000001110011111111111
100000000011000001110011111111111
100000000011000001110011111111111
100000000011000001110011111111111
100000000011000001110011111111111
100000000011000001110011111111111
100000000011000001110011111111111
100000000011000001110011111111111
100000000011000001110011111111111
100000000011000001110011111111111
100000000011000001110011111111111
100000000011000001110011111111111
100000000011000001110011111111111
100000000011000001110011111111111
100000000011000001110011111111111
100000000011000001110011111111111
100000000011000001110011111111111
100000000011000001110011111111111
100000000011000001110011111111111
100000000011000001110011111111111
100000000011000001110011111111111
100000000011000001110011111111111
100000000011000001110011111111111
100000000011000001110011111111111
100000000011000001110011111111111
100000000011000001110011111111111
100000000011000001110011111111111
100000000011000001110011111111111
100000000011000001110011111111111
100000000011000001110011111111111
100000000011000001110011111111111
100000000011000001110011111111111
100000000011000001110011111111111
100000000011000001110011111111111
100000000011000001110011111111111
100000000011000001110011111111111
100000000011000001110011111111111
100000000011000001110011111111111
100000000011000001110011111111111
100000000011000001110011111111111
100000000011000001110011111111111
100000000011000001110011111111111
100000000011000001110011111111111
100000000011000001110011111111111
100000000011000001110011111111111
100000000011000001110011111111111
100000000011000001110011111111111
100000000011000001110011111111111
100000000011000001110011111111111
100000000011000001110011111111111
100000000011000001110011111111111
100000000011000001110011111111111
100000000011000001110011111111111
100000000011000001110011111111111
100000000011000001110011111111111
100000000011000001110011111111111
100000000011000001110011111111111
100000000011000001110011111111111
100000000011000001110011111111111
100000000011000001110011111111111
100000000011000001110011111111111
100000000011000001110011111111111
100000000011000001110011111111111
100000000011000001110011111111111
100000000011000001110011111111111
100000000011000001110011111111111
100000000011000001110011111111111
100000000011000001110011111111111
100000000011000001110011111111111
100000000011000001110011111111111
100000000011000001110011111111111
100000000011000001110011111111111
100000000011000001110011111111111
100000000011000001110011111111111
100000000011000001110011111111111
100000000011000001110011111111111
100000000011000001110011111111111
100000000011000001110011111111111
100000000011000001110011111111111
100000000011000001110011111111111
100000000011000001110011111111111
100000000011000001110011111111111
100000000011000001110011111111111
100000000011000001110011111111111
100000000011000001110011111111111
100000000011000001110011111111111
100000000011000001110011111111111
100000000011000001110011111111111
100000000011000001110011111111111
100000000011000001110011111111111
100000000011000001110011111111111
100000000011000001110011111111111
100000000011000001110011111111111
100000000011000001110011111111111
100000000011000001110011111111111
100000000011000001110011111111111
100000000011000001110011111111111
100000000011000001110011111111111
100000000011000001110011111111111
100000000011000001110011111111111
100000000011000001110011111111111
100000000011000001110011111111111
100000000011000001110011111111111
100000000011000001110011111111111
100000000011000001110011111111111
100000000011000001110011111111111
100000000011000001110011111111111
100000000011000001110011111111111
100000000011000001110011111111111
100000000011000001110011111111111
100000000011000001110011111111111
100000000011000001110011111111111
100000000011000001110011111111111
100000000011000001110011111111111
100000000011000001110011111111111
100000000011000001110011111111111
100000000011000001110011111111111
100000000011000001110011111111111
100000000011000001110011111111111
100000000011000001110011111111111
100000000011000001110011111111111
100000000011000001110011111111111
100000000011000001110011111111111
100000000011000001110011111111111
100000000011000001110011111111111
100000000011000001110011111111111
100000000011000001110011111111111
100000000011000001110011111111111
100000000011000001110011111111111
100000000011000001110011111111111
100000000011000001110011111111111
100000000011000001110011111111111
100000000011000001110011111111111
100000000011000001110011111111111
100000000011000001110011111111111
100000000011000001110011111111111
100000000011000001110011111111111
100000000011000001110011111111111
100000000011000001110011111111111
100000000011000001110011111111111
100000000011000001110011111111111
100000000011000001110011111111111
100000000011000001110011111111111
100000000011000001110011111111111
100000000011000001110011111111111
100000000011000001110011111111111
100000000011000001110011111111111
100000000011000001110011111111111
100000000011000001110011111111111
100000000011000001110011111111111
100000000011000001110011111111111
100000000011000001110011111111111
100000000011000001110011111111111
100000000011000001110011111111111
100000000011000001110011111111111
100000000011000001110011111111111
100000000011000001110011111111111
100000000011000001110011111111111
100000000011000001110011111111111
100000000011000001110011111111111
100000000011000001110011111111111
100000000011000001110011111111111
100000000011000001110011111111111
100000000011000001110011111111111
100000000011000001110011111111111
100000000011000001110011111111111
100000000011000001110011111111111
100000000011000001110011111111111
100000000011000001110011111111111
100000000011000001110011111111111
100000000011000001110011111111111
100000000011000001110011111111111
100000000011000001110011111111111
100000000011000001110011111111111
100000000011000001110011111111111
100000000011000001110011111111111
100000000011000001110011111111111
100000000011000001110011111111111
100000000011000001110011111111111
100000000011000001110011111111111
100000000011000001110011111111111
100000000011000001110011111111111
100000000011000001110011111111111
100000000011000001110011111111111
100000000011000001110011111111111
100000000011000001110011111111111
100000000011000001110011111111111
100000000011000001110011111111111
100000000011000001110011111111111
100000000011000001110011111111111
100000000011000001110011111111111
100000000011000001110011111111111
100000000011000001110011111111111
100000000011000001110011111111111
100000000011000001110011111111111
100000000011000001110011111111111
100000000011000001110011111111111
100000000011000001110011111111111
100000000011000001110011111111111
100000000011000001110011111111111
100000000011000001110011111111111
100000000011000001110011111111111
100000000011000001110011111111111
100000000011000001110011111111111
100000000011000001110011111111111
100000000011000001110011111111111
100000000011000001110011111111111
100000000011000001110011111111111
100000000011000001110011111111111
100000000011000001110011111111111
100000000011000001110011111111111
100000000011000001110011111111111
100000000011000001110011111111111
100000000011000001110011111111111
100000000011000001110011111111111
100000000011000001110011111111111
100000000011000001110011111111111
100000000011000001110011111111111
100000000011000001110011111111111
100000000011000001110011111111111
100000000011000001110011111111111
100000000011000001110011111111111
100000000011000001110011111111111
100000000011000001110011111111111
100000000011000001110011111111111
100000000011000001110011111111111
100000000011000001110011111111111
100000000011000001110011111111111
100000000011000001110011111111111
100000000011000001110011111111111
100000000011000001110011111111111
100000000011000001110011111111111
100000000011000001110011111111111
100000000011000001110011111111111
100000000011000001110011111111111
100000000011000001110011111111111
100000000011000001110011111111111
100000000011000001110011111111111
100000000011000001110011111111111
100000000011000001110011111111111
100000000011000001110011111111111
100000000011000001110011111111111
100000000011000001110011111111111
100000000011000001110011111111111
100000000011000001110011111111111
100000000011000001110011111111111
100000000011000001110011111111111
100000000011000001110011111111111
100000000011000001110011111111111
100000000011000001110011111111111
100000000011000001110011111111111
100000000011000001110011111111111
100000000011000001110011111111111
100000000011000001110011111111111
100000000011000001110011111111111
100000000011000001110011111111111
100000000011000001110011111111111
100000000011000001110011111111111
100000000011000001110011111111111
100000000011000001110011111111111
100000000011000001110011111111111
100000000011000001110011111111111
100000000011000001110011111111111
100000000011000001110011111111111
100000000011000001110011111111111
100000000011000001110011111111111
100000000011000001110011111111111
100000000011000001110011111111111
100000000011000001110011111111111
100000000011000001110011111111111
100000000011000001110011111111111
100000000011000001110011111111111
100000000011000001110011111111111
100000000011000001110011111111111
100000000011000001110011111111111
100000000011000001110011111111111
100000000011000001110011111111111
100000000011000001110011111111111
100000000011000001110011111111111
100000000011000001110011111111111
100000000011000001110011111111111
100000000011000001110011111111111
100000000011000001110011111111111
100000000011000001110011111111111
100000000011000001110011111111111
100000000011000001110011111111111
100000000011000001110011111111111
100000000011000001110011111111111
100000000011000001110011111111111
100000000011000001110011111111111
100000000011000001110011111111111
100000000011000001110011111111111
100000000011000001110011111111111
100000000011000001110011111111111
100000000011000001110011111111111
100000000011000001110011111111111
100000000011000001110011111111111
100000000011000001110011111111111
100000000011000001110011111111111
100000000011000001110011111111111
100000000011000001110011111111111
100000000011000001110011111111111
100000000011000001110011111111111
100000000011000001110011111111111
100000000011000001110011111111111
100000000011000001110011111111111
100000000011000001110011111111111
100000000011000001110011111111111
100000000011000001110011111111111
100000000011000001110011111111111
100000000011000001110011111111111
100000000011000001110011111111111
100000000011000001110011111111111
100000000011000001110011111111111
100000000011000001110011111111111
100000000011000001110011111111111
100000000011000001110011111111111
100000000011000001110011111111111
100000000011000001110011111111111
100000000011000001110011111111111
100000000011000001110011111111111
100000000011000001110011111111111
100000000011000001110011111111111
100000000011000001110011111111111
100000000011000001110011111111111
100000000011000001110011111111111
100000000011000001110011111111111
100000000011000001110011111111111
100000000011000001110011111111111
100000000011000001110011111111111
100000000011000001110011111111111
100000000011000001110011111111111
100000000011000001110011111111111
100000000011000001110011111111111
100000000011000001110011111111111
100000000011000001110011111111111
100000000011000001110011111111111
100000000011000001110011111111111
100000000011000001110011111111111
100000000011000001110011111111111
100000000011000001110011111111111
100000000011000001110011111111111
100000000011000001110011111111111
100000000011000001110011111111111
100000000011000001110011111111111
100000000011000001110011111111111
100000000011000001110011111111111
100000000011000001110011111111111
100000000011000001110011111111111
100000000011000001110011111111111
100000000011000001110011111111111
100000000011000001110011111111111
100000000011000001110011111111111
100000000011000001110011111111111
100000000011000001110011111111111
100000000011000001110011111111111
100000000011000001110011111111111
100000000011000001110011111111111
100000000011000001110011111111111
100000000011000001110011111111111
100000000011000001110011111111111
100000000011000001110011111111111
100000000011000001110011111111111
100000000011000001110011111111111
100000000011000001110011111111111
100000000011000001110011111111111
100000000011000001110011111111111
100000000011000001110011111111111
100000000011000001110011111111111
100000000011000001110011111111111
100000000011000001110011111111111
100000000011000001110011111111111
100000000011000001110011111111111
100000000011000001110011111111111
100000000011000001110011111111111
100000000011000001110011111111111
100000000011000001110011111111111
100000000011000001110011111111111
100000000011000001110011111111111
100000000011000001110011111111111
100000000011000001110011111111111
100000000011000001110011111111111
100000000011000001110011111111111
100000000011000001110011111111111
100000000011000001110011111111111
100000000011000001110011111111111
100000000011000001110011111111111
100000000011000001110011111111111
100000000011000001110011111111111
100000000011000001110011111111111
100000000011000001110011111111111
100000000011000001110011111111111
100000000011000001110011111111111
100000000011000001110011111111111
100000000011000001110011111111111
100000000011000001110011111111111
100000000011000001110011111111111
100000000011000001110011111111111
100000000011000001110011111111111
100000000011000001110011111111111
100000000011000001110011111111111
100000000011000001110011111111111
100000000011000001110011111111111
100000000011000001110011111111111
100000000011000001110011111111111
100000000011000001110011111111111
100000000011000001110011111111111
100000000011000001110011111111111
100000000011000001110011111111111
100000000011000001110011111111111
100000000011000001110011111111111
100000000011000001110011111111111
100000000011000001110011111111111
100000000011000001110011111111111
100000000011000001110011111111111
100000000011000001110011111111111
100000000011000001110011111111111
100000000011000001110011111111111
100000000011000001110011111111111
100000000011000001110011111111111
100000000011000001110011111111111
100000000011000001110011111111111
100000000011000001110011111111111
100000000011000001110011111111111
100000000011000001110011111111111
100000000011000001110011111111111
100000000011000001110011111111111
100000000011000001110011111111111
100000000011000001110011111111111
100000000011000001110011111111111
100000000011000001110011111111111
100000000011000001110011111111111
100000000011000001110011111111111
100000000011000001110011111111111
100000000011000001110011111111111
100000000011000001110011111111111
100000000011000001110011111111111
100000000011000001110011111111111
100000000011000001110011111111111
100000000011000001110011111111111
100000000011000001110011111111111
100000000011000001110011111111111
100000000011000001110011111111111
100000000011000001110011111111111
100000000011000001110011111111111
100000000011000001110011111111111
100000000011000001110011111111111
100000000011000001110011111111111
100000000011000001110011111111111
100000000011000001110011111111111
100000000011000001110011111111111
100000000011000001110011111111111
100000000011000001110011111111111
100000000011000001110011111111111
100000000011000001110011111111111
100000000011000001110011111111111
100000000011000001110011111111111
100000000011000001110011111111111
100000000011000001110011111111111
100000000011000001110011111111111
100000000011000001110011111111111
100000000011000001110011111111111
100000000011000001110011111111111
100000000011000001110011111111111
100000000011000001110011111111111
100000000011000001110011111111111
100000000011000001110011111111111
100000000011000001110011111111111
100000000011000001110011111111111
100000000011000001110011111111111
100000000011000001110011111111111
100000000011000001110011111111111
100000000011000001110011111111111
100000000011000001110011111111111
100000000011000001110011111111111
100000000011000001110011111111111
100000000011000001110011111111111
100000000011000001110011111111111
100000000011000001110011111111111
100000000011000001110011111111111
100000000011000001110011111111111
100000000011000001110011111111111
100000000011000001110011111111111
100000000011000001110011111111111
100000000011000001110011111111111
100000000011000001110011111111111
100000000011000001110011111111111
100000000011000001110011111111111
100000000011000001110011111111111
100000000011000001110011111111111
100000000011000001110011111111111
100000000011000001110011111111111
100000000011000001110011111111111
100000000011000001110011111111111
100000000011000001110011111111111
100000000011000001110011111111111
100000000011000001110011111111111
100000000011000001110011111111111
100000000011000001110011111111111
100000000011000001110011111111111
100000000011000001110011111111111
100000000011000001110011111111111
100000000011000001110011111111111
100000000011000001110011111111111
100000000011000001110011111111111
100000000011000001110011111111111
100000000011000001110011111111111
100000000011000001110011111111111
100000000011000001110011111111111
100000000011000001110011111111111
100000000011000001110011111111111
100000000011000001110011111111111
100000000011000001110011111111111
100000000011000001110011111111111
100000000011000001110011111111111
100000000011000001110011111111111
100000000011000001110011111111111
100000000011000001110011111111111
100000000011000001110011111111111
100000000011000001110011111111111
100000000011000001110011111111111
100000000011000001110011111111111
100000000011000001110011111111111
100000000011000001110011111111111
100000000011000001110011111111111
100000000011000001110011111111111
100000000011000001110011111111111
1111111111111111111111111111111111111111