NO ./images/hell/floor.xpm
SO ./images/hell/wall1.xpm
WE ./images/hell/wall2.xpm
EA ./images/hell/wall3_1.xpm

C 0, 0, 0
F 255, 86, 2

        1111111111111111111111111
        1E01000000100000000000001
        1011000000100000000000001
        1011000000100000010000001
        1011000000100000010000001
        1011000000100000010000001
        1011000000100000010000001
        1011000000100000010000001
        1000000000000000010000001
111111111011000001110010010000001
100000000011000001110011111111111
111111111111101110000001
11111111111100011101001011111
11000000110101011100000010001
10000000000000001100000010001
10000000000000001101010010001
11000001110101011111011110011
11110111 1110101 101111010001
11111111 1111111 111111111111
